Hello friend, your "princess toadstool" is now in another castle...
───────▄█──────────█─────────█▄───────
─────▐██──────▄█──███──█▄─────██▌─────
────▐██▀─────█████████████────▀██▌────
───▐██▌─────██████████████─────▐██▌───
───████────████████████████────████───
──▐█████──██████████████████──█████▌──
───████████████████████████████████───
────███████▀▀████████████▀▀███████────
─────█████▌──▄▄─▀████▀─▄▄──▐█████─────
───▄▄██████▄─▀▀──████──▀▀─▄██████▄▄───
──██████████████████████████████████──
─████████████████████████████████████─
▐██████──███████▀▄██▄▀███████──██████▌
▐█████────██████████████████────█████▌
▐█████─────██████▀──▀██████─────█████▌
─█████▄─────███────────███─────▄█████─
──██████─────█──────────█─────██████──
────█████────────────────────█████────
─────█████──────────────────█████─────
──────█████────────────────█████──────
───────████───▄────────▄───████───────
────────████─██────────██─████────────
────────████████─▄██▄─████████────────
───────████████████████████████───────
───────████████████████████████───────
────────▀█████████▀▀█████████▀────────
──────────▀███▀────────▀███▀──────────
SILICON{411_y0Ur_53v3R5_4r3_b3L0ng_t0_U5}